SSSSSSSSSSSSSSS
S.............S
S......1......S
S.............S
S.............S
S.....BBB.....S
S.............S
S.....WWW.....S
S.............S
S.............S
S.............S
SSSSSS...SSSSSS
     S...S
     S...S
SSSSSS...SSSSSS
S.............S
S.............S
S..W.......B..S
S..W.......B..S
S..W.......B..S
S..W.......B..S
S..W.......B..S
S..W.......B..S
S.............S
S.............S
SSSSSSSSSSSSSSS